MMMMMMMMMMMMMMM
M             M
MMMMMMMM MMMMMM
M        M    M
M  MMMMMMMMMM M
M             M
MMMMMMMM MMMMMM
M      M      M
M MMMMMMMMMMM M
M      M      M
M MMMMMMMM MMMM
M             M
MMMMMMMMMMMMM M
M             M
MGMMMMMMMMMMMMM